.X.X......
.X.X......
.X........
.X.XXXXXXX
sX.X......
.X.X..X..g
...X..X...
.X....XXXX
.X.X......
...X......
