.....X.X.g
.....X.X..
...X.X.X.X
...X.X.X..
...X...XX.
s..XXX.X..
...X.X...X
..q..X.X..
..XXXX.XX.
.....X....
