.X.X......
.X.X......
.X........
.X.XXXXXXX
gX.X......
.X.X..X..s
...X..X...
.X....XXXX
.X.X......
...X......
