g.........
..........
..........
..XXXXX...
.qX...X...
.qX...X...
..X...X...
..........
..........
....s.....
