..........
...X..X...
.X.X..X.X.
.X.XXXX.X.
.X..X...X.
.XXXX.XXX.
....X.....
....X..X..
....X..X..
...sXg.X..
