.....s....
...X..X...
.X.X..X.X.
.X.XXXX.X.
.X..X...X.
.XXXXXXXX.
....X.....
....X..X..
....X..X..
....Xg.X..
