....s.....
..........
..........
..XXXXX...
..X.g.X...
..X...X...
..X...X...
..........
..........
..........
