.X...X.X.s
X.....X...
..XX.X.X.X
XX....X...
........X.
.X.XX..X..
X....X...X
.......X..
X.X..X..X.
g.....X...
